012300000000000
000033333333333
333333330000000
011111111333330
011111111000000
011111111000000
011111133333000
000022033333000
000022000000000
000022000000000