111111111111111
100222222000001
100222222000001
100333322220001
100333322220001
100222222220001
100222222220001
100220022000001
100220022000001
111111111111111