222222222222222
222112112211122
111133311111121
141133311144411
112433314444444
123412341234123
324123321111122
233212333321111
234444443221111
441221222233333